EA                                                                 textures/matrix.xpm
NO textures/matrix.xpm
C 133, 185, 230
F 48, 31, 61
WE textures/matrix.xpm
SO   textures/matrix.xpm

                                                                                    111
                                                                                    1W1
                                                                                    101
                                                                                    101
                                                                                    101
                                                                                    10111111111111111
                                                                                 111101000000000000001
                                                                                 100001111111111111111
                                                                                 100000100000000101001
                                                                                 11000011000000010100111111111111111111111111111111
                                                                         1111111110000010000000000000000000000000000000000000000001
                                                                         1000000000000000000000010100111111111111111111111111111111
                                                                         1111111111000000000000000001
                                                                                 10000000000000000001
                                                                                 11000000001100000001
                                                                                 10000000000000000001
                                                                                 11111111111111110111
                                                                                 10000000000000000001
                                                                                 11110111111111111111
                                                                                    101
                                                                                    101
                                                                                    101
                                                                                    101
                                                                                    101
                                                                                    111
