EA                                                                 textures/simonkraft/bookshelf_01.xpm
NO textures/simonkraft/bookshelf.xpm
C 133, 185, 230
F 48, 31, 61
WE textures/simonkraft/bookshelf_01.xpm
SO   textures/simonkraft/bookshelf_01.xpm

 1111111111111111111
100001111111101010111
100000100000000101001
1100001100000001010011111111111111111111111111111
10000010000000000000000000000000000000000000000001
1000000000000001010011111111111111111111111111111
11000000000000000001
10000000000000000001
1111111111111111S111
10000000000000000001
11111111111111111111
