EA                                                                 textures/cub_east.xpm
NO textures/bajeanno.xpm
C 217, 217, 138
F 217, 217, 138
WE textures/bajeanno.xpm
SO   textures/cub_south.xpm

           111
           101
           101
           101
           101
           10111111111111111
        111101000000000000001
        100001111111111111111
        100000100000000101001
        11000E110000000101001111111111111111111111
11111111100000100000000000000000000000000000000001
100000000000000000d0000101001111111111111111111111
11111111100000000000000000011
        10000000000000000001
        1000100000110000D001
        10000000000000000001
        11111111111111110111
        10000000000000000001
        11110111111111111111
           101
           101
           101
           101
           101
           111