EA                                                                 textures/bajeanno.xpm
NO textures/bajeanno.xpm
C 133, 185, 230
F 48, 31, 61
WE textures/bajeanno.xpm
SO   textures/bajeanno.xpm

           111
           101
           101
           101
           101
           101
        11110111111111111111
        100001111111101010111
        100000100000000101001
        110000110000000101001111111111111111111111
11111111100000100000000000000000000000000000000001
10000000000000000000000101001111111111111111111111
1111111111000000000000000001
        10000000000000000001
        11000000000000000001
        10000000000000000001
        1111111111111111S111
        10000000000000000001
        11110111111111111111
           101
           101
           101
           101
           101
           111