EA                                                                 textures/simonkraft/bookshelf_01.xpm
NO textures/simonkraft/bookshelf.xpm
C 133, 185, 230
F 48, 31, 61
WE textures/simonkraft/bookshelf_01.xpm
SO   textures/simonkraft/bookshelf_01.xpm

           111
           101
           101
           101
           101
           10111111111111111
        111101000000000000001
        100001111111111111111
        100000100000000101001
        11000E110000000101001111111111111111111111
11111111100000100000000000000000000000000000000001
100000000000000000000N0101001111111111111111111111
1111111110000000000000000001
        10000000000000000001
        10000000001100000001
        10000000000000000001
        11111111111111110111
        10000000000000000001
        11110111111111111111
           101
           101
           101
           101
           101
           111