EA                                                                 textures/simonkraft/bookshelf.xpm
NO textures/simonkraft/bookshelf.xpm
C 217, 217, 138
F 217, 217, 138
WE textures/simonkraft/bookshelf.xpm
SO   textures/simonkraft/bookshelf.xpm

 111111111111111111111111111111
 1GGGGGGGGGGGGGGGGGGGGGGGGGGGG1
 1G00000000000000000000000000G1
 1G00000000000000000001000000G1
 1G00000000000000000001000000G1
 1G00000111111111100001000000G1
 1G00000000000000N00001000000G1
 1G00000000000000000001000000G1
 1GGGGGGGGGGGGGGGGGGGGGGGGGGGG1
 111111111111111111111111111111
