EA                                                                 textures/cub_east.xpm
NO textures/bajeanno.xpm
C 217, 217, 138
F 217, 217, 138
WE textures/bajeanno.xpm
SO   textures/cub_south.xpm

           1
11111111111D1111111111111
10000000000G0000000000001
1000000000000000000000001
10000000000G0000000000001
1100000000000000000000001
10000000000G0000000000001
111110000000000000N000001
1111111111111111111111111