EA                                                                 textures/bajeanno.xpm
NO textures/bajeanno.xpm
C 133, 185, 230
F 48, 31, 61
WE textures/bajeanno.xpm
SO   textures/bajeanno.xpm

111111111111111111111111111111111111111111
1GGGGGGGGGG1
1GGGGGGGGGG1
1GGGGGGGGGG1
1GGGGGGGGGG1
1GGGGGGGGGG1
1GGGGGGGGGG1
1GGGGGGGGGG1
1GGGGGGGGGG1
1GGGGGGGGGG1
1GGGGGGGGGG1
10GGGGGGGGN111111111111111111111111111111
1GGGGGGGGGG1
1GGGGGGGGGG1
1GGGGGGGGGG1
1GGGGGGGGGG1
1GGGGGGGGGG1
1GGGGGGGGGG1
1GGGGGGGGGG1
1GGGGGGGGGG1
1GGGGGGGGGG1
1GGGGGGGGGG1
1GGGGGGGGGG1
1GGGGGGGGGG1
1GGGGGGGGGG1
1GGGGGGGGGG1
1GGGGGGGGGG1
1GGGGGGGGGG1
1GGGGGGGGGG1
1GGGGGGGGGG1
1GGGGGGGGGG1
1GGGGGGGGGG1
1GGGGGGGGGG1
111111111111111111111111111111111111111111