EA                                                                 textures/simonkraft/bookshelf.xpm
NO textures/simonkraft/bookshelf.xpm
C 217, 217, 138
F 217, 217, 138
WE textures/simonkraft/bookshelf.xpm
SO   textures/simonkraft/bookshelf.xpm

11111111111111111111111
10000000000000000000001
10000000000000000010001
10000000000000000010001
10000000111110000010001
10000000000N00000010001
10000000000000000010001
10000000000000000000001
11111111111111111111111
