EA 		truc.xpm
NO truc.xpm
C -0,222,	0
F 255,5,000
WE      truc.xpm
SO    truc.xpm


11111111111111111111
10000000000000000001
11000000000000000001
10000000000000000001
1100000000N000000001
10000000000000000001
11000000000000000001
10000000000000000001
11111111111111110111
10000000000000000001
11111111111111111111