EA                                                                 textures/cub_east.xpm
NO textures/bajeanno.xpm
C 217, 217, 138
F 217, 217, 138
WE textures/bajeanno.xpm
SO   textures/cub_south.xpm

1111111111111111111111111111111111111111111111111111111111111111111111111111111
1D1D1D1D1D1D1D1D1D1D1D1D1D1D1D11D1D1D1D1D1D1D1D1D1D1D1D1D1D1D1D1D1D1D1D1D1D1D11
11111111111111111GGGGGGGGGGGGG1111111111111111111111111111111111111111111111111
100000000000000000000000GGGGGGGGGGGGGGGGGGGGGGGGGGGGGGGGGGGGGGGGGGGGGGGGGGGGG1
10000000000G000000000000GGGGGGGGGGGGGGGGGGGGGGGGGGGGGGGGGGGGGGGGGGGGGGGGGGGGG1
10000000000G000010000000GGGGGGGGGGGGGGGGGGGGGGGGGGGGGGGGGGGGGGGGGGGGGGGGGGGGG1
11000000000G0000D0000000GGGGGGGGGGGGGGGGGGGGGGGGGGGGGGGGGGGGGGGGGGGGGGGGGGGGG1
10000000000G000010000000GGGGGGGGGGGGGGGGGGGGGGGGGGGGGGGGGGGGGGGGGGGGGGGGGGGGG1
11111000000G000000N00000GGGGGGGGGGGGGGGGGGGGGGGGGGGGGGGGGGGGGGGGGGGGGGGGGGGGG1
111111111111111111111111111111111111111111111111111111111111111111111111111111