SO 		truc.xpm
NO truc.xpm
C 255,222,	000
F 255,255,000
WE truc.xpm



EA truc.xpm

dwdoewopdkewopfkewpkfoepkf
11111111111111111111







