SO 		truc.xpm
NO truc.xpm

11111111111111111111

WE truc.xpm
EA truc.xpm


C 255,222,	000
F 255,255,000




