EA 		truc.xpm
NO truc.xpm
C 100000000000000000000000000000000000000000255,222,	0
F 255,5,000
WE      truc.xpm
SO    truc.xpm


111111111111111111111111111111111111111111111111111
10000N000000000000000000000000000000000000000000001
100000000000000000000000000000000000000000000000001
100000000000000000000000111111111111111111110000001111111111111111111111111
1000000000000000000000001                  10000000000000000000000000000011
1000000000000000000111111                  10000001111111111111111111111111
1000000000000000000111111                  10000001
100000000000000000011111111111111111111111110000001
111111111111111101111111100000000000000000000000001
100000000000000000000000000000000000000000000000001
111111111111111111100011111111111111111111111111111111
                100010011
             1111100011
             1000000001
             1111110001
                  11111


