EA                                                                 textures/bajeanno.xpm
NO textures/bajeanno.xpm
C 133, 185, 230
F 48, 31, 61
WE textures/bajeanno.xpm
SO   textures/bajeanno.xpm

111111111111111111111111111111111111111111
1111111111111111111111111111
1100000000000000000000000011
1100000000000000000000000011
1100000001000000000000000011
1100000001000100000000000011
1100000111000000000000000011
1100000000000000000000000011
1100000000000000000000000011
1100000000N00000000000000011
1111111111111111111111111111
111111111111111111111111111