SO
SO truc.xpm
NO truc.xpm
EA truc.xpm
WE truc.xpm


C 255,222,222
F 222,255,255


1111111111111111111111111111111
1111111111111111111111111111111