EA                                                                 textures/bajeanno.xpm
NO textures/bajeanno.xpm
C 133, 185, 230
F 48, 31, 61
WE textures/bajeanno.xpm
SO   textures/bajeanno.xpm

111111111111111
100000000000011
100000000000111
1000N0000001111
1001D1000011111
100000000111111
111111111111111