EA                                                                 textures/cub_east.xpm
NO textures/bajeanno.xpm
C 217, 217, 138
F 217, 217, 138
WE textures/bajeanno.xpm
SO   textures/cub_south.xpm

           111
           1D1
           101
           101
           101
           10111111111111111
        111101000000000000001
        100001111111111111111
        100000100000000101001
        110000D10000000101001111111111111111111111
11111111100000100000000000000000000000000000000001
1000000000000000000000101001111111111111111111111
11111111100000000000000000011
       1D0000000000N00000001
        1GGG1000001100000001 111
        10000000000000000001 101
        1D111111111111110111 111
        10000000000000000001
        11110111111111111111
           101
           101
           101
           101
           101
           111